15 21
#####################
#p* * *1* * *2* * * #
# #*#*#*#*#*#*#*#*#*#
#*1 * * * * * * * 2*#
#*#*# #*#*# #*#*# #*#
#* * *1* *2* *1* * *#
# #*#*#*#*#*#*#*#*#*#
#*2 * * * * * * * 1*#
#*#*# #*#*# #*#*# #*#
#* * *2* *1* *2* *x#
# #*#*#*#*#*#*#*#*#*#
#*1 * * * * * * * 2*#
#*#*#*#*#*#*#*#*#*#*#
# * * *1* * *2* * * #
#####################