15 21
#####################
#p     *   1  *    x#
# # # #*# # #*# # #*#
#  *      *      1 *#
#*# # # # #*# # # # #
#*  *         *   * #
# #*# # #*# # # #*#*#
#*  *       *  1  * #
# # # # # # #*# # # #
#*    *   *         #
#*# # # # # # # # #*#
#*  *   * 1 *   * * #
# # # # #*# # # # # #
#  *   *     *   *  #
#####################