15 21
#####################
#p  * 5 *   * 6 *   #
# #*# # #*# # #*# #*#
#*    *  3    *   1 #
# # #*# # # #*# # # #
#*1 *   * 4 *   * 2*#
# #*# # #*# # # #*# #
#*    * 6 *   *   * #
# # # # # # #*# # #*#
#*2 *   3   *   * 1 #
# #*# # # # # # # # #
#*  * 7 *   * 2 *   #
# # # #*# # #*# # #*#
#  *   *         *  #
#####################