15 21
#####################
#p* * *1* * *2* * * #
# #*#*#*#*#*#*#*#*#*#
#*1 * * * * * * * 2*#
#*#*# #*#*# #*#*# #*#
#* * *1* *3* *1* * *#
# #*#*#*#*#*#*#*#*#*#
#*2 * * * * * * * 1*#
#*#*# #*#*# #*#*# #*#
#* * *2* *1* *2* * #
# #*#*#*#*#*#*#*#*#*#
#*1 * * * *x* * * 2*#
#*#*#*#*#*#*#*#*#*#*#
# * * *1* * *2* * * #
#####################