15 21
#####################
#p*1*2*1 2*1*2*1*2*1#
#*#*#*#*#*#*#*#*#*#*#
#2*1*2*1*2*1*2*1*2*1#
#*#*#*#*#*#*#*#*#*#*#
#1*2*1*2*1*2*1*2*1*2#
#*#*#*#*#*#*#*#*#*#*#
#2*1*2*1*2*1*2*1*2* #
#*#*#*#*#*#*#*#*#*#*#
#1*2*1*2*1*2*1*2*1*2#
#*#*#*#*#*#*#*#*#*#*#
#2*1*2*1*2*1*x*1*2*1#
#*#*#*#*#*#*#*#*#*#*#
#1*2*1*2*1*2*1*2*1* #
#####################