15 21
#####################
#p  * 1 *   * 2 *   #
# #*# # #*# # #*# #*#
#*1 *   * 4 *   * 2*#
# # # # #*# # # #*# #
#*x   * 6 *   x   * #
# # # # # # #*# # #*#
#*2 *       *   * 1 #
# #*# # # # # # # # #
#*  * 7 *   * 2 *   #
# # # #*# # #*# # #*#
#  *   *         *  #
#####################